#Accusative
bis – “until, up to, as far as”
durch – “through, by means of”
für – “for”
ohne – “without”
gegen – “against, toward”
um – “around, for”
entlang – “along”
#Dative
ab – “from” (time)
aus – “from, out of”
außer – “except for”
bei – “at, near, at the house of”
dank – “thanks to”
entgegen – “contrary to”
gegenüber – “opposite”
gemäß – “according to”
laut – “according to”
mit – “with”
nach – “after, to”
seit – “since, for”
von – “from, of”
zu – “to”
zufolge – “according to”
#Two-way German Prepositions
an – “on (a vertical surface)”
auf – “on top of (horizontal surface)”
hinter – “behind”
in – “in, into”
neben – “next to”
entlang – “along”
über – “above”
unter – “under”
vor – “in front of”
zwischen – “between”
#German Genitive Prepositions
anstatt (often abbreviated to just statt) – “instead [of]”
außerhalb – “outside of”
beiderseits – “on both sides”
diesseits – “on this side”
innerhalb – “inside of”
jenseits – “on the other side”
oberhalb – “above”
trotz – “despite”
unterhalb – “below”
wegen – “because of”
während – “during”